낮 - день                 - day
그리고 - и                 - and
저녁 - вечер               - evening
발레 - балет               - ballet
볼쇼이_극장 - Большой театр - Grand Theatre
시작하다 - начинать         - start
부터 - с, от, из           - from
반 - половина              - half
까지 - до                   - to
표 - билет                  - ticket
얼마 - сколько              - how many
루블 - рубль                - rouble
오후 - вт половина дня      - PM
병원 - больница             - hospital
모레 - послезавтра          - day after tomorrow
보통 - обычно               - usually
밤 - ночь                   - night
수업 - урок                 - lesson
프랑스어 - французский язык - french
잠 - сон                   - sleep
잠을자다 - спать           - sleeping
부엌 - кухня               - kitchen
요리 - блюдо               - dish
요리하다 - готовить блюдо  - prepare dish
상점 - магазин, лавка      - store
거실 - гостиная            - living room
방학 - каникулы            - break, vacation
겨울_반학 - зимние каникулы - winter vacation
시험 - экзамен             - test
걸어가다 - идти пешком      - walk
영희 - Ёнхи                - Alice?
잘하다 - хорошо делать      - do well
그런데 - а, кстати, однако - by the way
잘_못하다 - делать не очень хорошо - do not so well
축구 - футбол              - football
그렇지만 - однако, но       - but 
싫어하다 - не любить, недолюбливать - dislike
머리 - голова              - head
배 - живот                 - abdomen, belly, ship
안드레이 - Андрей           - Andrei
옆집 - соседний дом        - house Next Door
살다 - жить                - live
거의 - почти               - almost
