창가 - место рядом с окном - near window
창가에 - около окна - By the window
종업원 - официант, персонал - employee, servant
메뉴 - меню - menu
갖다 주다 - принести и отдать - put feed
각자 - каждый - each
고르다 - выбирать - choose
찌개 - густой суп - stew
김밥 - кимпап, рис завернутый в водоросли - kimbab
잠시 후 - спустя некоторое время - after a while
내다 - платить, сдавать - pay, give
주문하다 - заказывать - order from
갈비 - ребра - rib
음료수 - прохладительные напитки - beverages
콜라 - кола-кола - cola
병 - бутылка - bottle
맛있게 드세요 - приятного аппетита - Bon appetite
잘 먹었습니다 - спасибо было очень вкусно - I really enjoyed the meal
맛있어요 - вкусно - Delicious
매워요 - остро - Spicy
달다 - сладко - sweet
짜다 - соленый - salty
시다 - кислый - sour
쓰다 - горький - bitter
조금 - немного - a little
싱거워요 - пресно - flavorless
조금 이따가 - немного спустя - little bit later
나중에 - потом - Afterwards
밖에서 - на улице - out
치우다 - убирать - Tidy up
십분 뒤에 - через 10 минут - After ten minutes
놀다 - играть - play
오래 - долго - long
과식하다 - обьедаться, переедать - surfeit, overeating
심심하다 - скучно - Bored






