사전 - словарь - dictionary
언제 - когда - when
공책 - тетрадь - notebook
의자 - стул - chair
수첩 - записная книжка - pocket book
좋아하다 - нравиться, любить - like
접지 - журнал - magazine
저기 - там - there
접시 - тарелка - plate
지우개 - ластик - eraser 
빵 - хлеб - bread
여자 - женщина,девушка - woman, girl
아이들 - дети - children
중국 - Китай - China
연필 - карандаш - pencil 
착하다 - добрый, хороший - be good
오늘 - сегодня - today
그 - этот, тот - that
편지 - письмо - letter
물 - вода - water
동생 - мл брат сестра - young sibling
적다 - мало - less
사진 - фотография - photo
종이 - бумага - paper
조카 - племянник(ца) - nephew
들어오십시오 - заходите - come in
앉으십시오 - садитесь - sit
칠판 - школьная доска - blackboard
지금 - сейчас - now
부르다 - петь - sing ??
이름 - имя - name
교과서 - учебник - textbook
사진기 - фотоаппарат - camera 
부부 - супруги - couple
선생님 - учитель - teacher
손님 - гость, клиент - guest, client
형 - старш брат - older brother mal
누구 - кто - who 
대학샌 - студент - college student
학생 - школьник - student
너 - вы - you
일본 - Япония - Japan
영화 - кино, фильм - film
전화 - телефон - phone
있다 - быть, находиться - be
여기 - здесь - here, this place
없다 - не быть, отсутствовать - no, absent
그러면 - в таком случае - then, in this case
어디 - где - where
에 - в - at
미샤 - Миша - Misha
식당 - столовая, ресторан
사무실 - кабинет, контора - office
옆 - бок - size
아저씨 - дядя - uncle, Mr.
와 - и - and_1
과 - и - and 2
주다 - давать - give
주십시오 - дайте, пожалуйста - please
교실 - класс, аудитория - classroom
학교 - школа - school
시계 - часы - clock
방 - комната - room
집 - дом - house
회사 - фирма - firm
우체국 - почта - post office
은행 - банк - bank
바로 - как раз, сразу, прямо - immediately
