통화 - телефонный разговор - telephone call
수화기 - телефонная трубка - receiver
들다 - поднимать, брать - hold
번호 - номер - number
누르다 - нажимать - press
통화 중 - занято - calling
해보다 - попробовать сделать - try
후에 - после - after
신호 - сигнал - signal
신호가 가다 - идти (гудки) - signals go
드디어 - наконец-то - finally
여보세요 - алло - hello
잘못 - ошибочно, неправильно - mistake, error
큲다 - разрывать, прекращить - sever, quit
머리가 나쁘다 - глупый, плохая голова - fool, bad head
머리가 좋다 - умный - clever
교수님 - профессор - professor
바꾸어 주다 - менять, передать трубку - give phone
뵙다 - вежл встречаться - meet, encounter
돌아오다 - возвращаться - come back
조금 있으면 - если немного подождать - In a little while
좀 - пожалуйста - please
부탁하다 - позвать, попросить - request, ask for
계시다 - есть - exist, be
설거지 하다 - мыть посуду - do dishes
기타 - гитара - guitar
기타를 치다 - играть на гитаре - play guitar
곧 - скоро - soon
도착하다 - приезжать, приходить - arrive
쓰레기 - мусор - garbage
버리다 - выбрасывать - abandon, damp
놀러 가다 - идти развлекаться - go out for play
초대하다 - приглашать - invite
함께 - вместе - together
친하다 - близкий - close
케이크 - торт - cake
굉장히 - грандиозно, ужасно, очень - very, greatly
힘이 세다 - сильный - Strength
그때 - в то время, тогда - then
들어오다 - заходить - come in
벨 - звонок - bell, phone ring
소리가 나다 - звучать - sound
노력 - старания - effort
노력을 하다 - стараться - it is an effort
쓰다 - надевать - put on
일꾼 - рабочий - workman
걸다 - звонить, набирать - call, dial

