이제 - теперь - now
더 - еще, более - more
열다 - открывать - open
불 - огонь, свет - light, fire
켜다 - включать, зажигать - switch on
부르다 - звать - call
큰소리로 - громко - loud
건강하다 - здоровый - health
비행기 - самолет - plane
약속을_하다 - обещать, договариваться - make a promise
조용히 - тихо, спокойно - quiet
조용히_하다 - вести себя тихо - keep silent
연락을_하다 - связываться, звонить - contact
글씨 - почерк, буквы - letter
분명하다 - ясный, очевидный - clear
분명하게 - разборчиво - clearly
말_하다 - говорить - talk
시끄럽게 - шумно - loudly
시끄럽게_하다 - вести себя шумно - noisy
이쪽 - эта сторона - this, our side 
이쪽으로 - в эту сторону - over here
만지다 - трогать - touch
싸우다 - ссориться, ругаться, драться - fight, quarrel 
빨리 - быстро - fast
건너가다 - переходить, переправляться - cross
그리다 - рисовать - paint
거짓말 - ложь - lie
거짓말_하다 - лгать - lying
그쪽 - та сторона - that side
끄다 - выключать, тушить - switch off, extinguish
가져오다 - приносить, брать с собой - bring
운전을_하다 - водить машину - drive car
시키다 - заказывать, заставлять - have, get
함께 - вместе - together
운전 - вождение автомобиля - driving
춤 - танец - dance
춤_추다 - танцевать - to dance
자리 - место - place
바꾸다 - меняться - change
끝내다 - заканчивать - finish
바닷가 - берег моря - beach
박물관 - музей - museum
서점 - книжный магазин - bookstore
교회 - церковь - church
때 - время - time
크레파스 - мелки для рисования - Crayons
떡 - ток (рисовый паровой хлебец) - tok, rice bread
쌀가루 - рисовая мука - rice flour
전철 - электропоезда - electric train
상자 - ящик - box
나무 - дерево - tree
기차 - поезд - train
준비하다 - подготавливать(ся) - prepare
식사 - принятие пищи - meal
후에 - после - after
별장 - дача - villa
공항 - аэропорт - airport
와/과_함께 - вместе с - with
저쪽으로 - в ту сторону - that way
또 - ещё, опять - another



