생각 - мысль - thought
생각하다 - думать - think
빨래하다 - стирать - wash
영어 - английский язык - english language
영어_공부 - изучение английсколо - learning english
크게 - громко - loud
웃다 - смеяться - Laugh
수영장 - бассейн - Swimming pool
침대 - кровать - bed
바쁘다 - занятый - busy
뉴스 - новости - news
주방 - кухня - kitchen
운동 - физкультура, спорт - sport
운동하다 - заниматься физкультурой - Exercise, training
민희 - Минхи          - Minhui
김치 - кимчи          - kimchi
맵다 - острый (вкус)  - spicy
값 - цена             - price
싸다 - дешевый         - cheap
연습문제 - упражнение   - exercise
쉽다 - легкий, простой - easy
어렵다 - трудный       - difficult
따뜻하다 - теплый      - warm
소풍 - пикник         - excursion
한자 - китайский иероглиф ханча - Chinese character, Hanja
약속 - обещание, договор - promise, appointment
지키다 - держать, охранять - abide by, defend
시험을_치다 - сдавать экзамен - hit test
카드 - открытка, карточка      - card
보내다 - отправлять            - send
남자_친구 - друг, возлюбленный - boyfriend
사장님 - директор фирмы          - the boss
빌리다 - брать взаймы, напрокат  - borrow
초대 - приглашение               - invitation
초대를_받다 - получить приглашение - receive invitation
사탕 - конфеты          - candy
먹이 - корм             - animal feed
엽서 - открытка         - postcard
비서 - секретарь        - Secretary
연락 - сообщение        - message
녹음기 - магнитофон     - recorder
배가_부르다 - сытый      - full
