가끔 - изредка - Sometimes
치과 - стоматология - Dentist
아프다 - болеть - pain
진찰 - врачебный осмотр - Doctor examination
진찰을 받다 - подвергаться врачебному осмотру - Undergo a medical examination
받다 - получать - receive
벌리다 - открывать - open
충치 - кариес - cavity
이 - зуб - teeth
잇몸 - десны - gum
입 - рот - mouth
치료 - лечение - Treatment
치료를 받다 - лечиться - Undergo treatment
치료를 하다 - лечить - Is Treated
직접 - сам - directly
열 - температура - heat, fever
열이 나다 - высокая температура - have a fever
이틀 - два дня - two days
드리다 - давать, преподносить - give, donate, provide
식후 - после еды - after a meal
뒤 - зад, затем - rear
조금 전 - некоторое время назад - A little while ago
약 - лекарство - medicine
그냥 - просто - just
잘하다 - делаете хорошо - do well
다른 - другая - another
이미 - уже - already
추우다 - холодно - cold
외투 - пальто - coat
모르다 - не знать - do not know
아무도 - никого - no one
자세히 - внимательно - details
결석 - пропуск - absence
결석하다 - пропускать - be absent
시작 - старт - start
시작하다 - начинать - start, begin
낫다 - проходить, лучше - heal, better
아직도 - все еще - still
진찰하다 - осматривать больного - examine
감기약 - лекарство от простуды - cold medicine
기침 - кашель - cough
기침약 - лекарство от кашля - cough medicine
두통 - головная боль - headache
두통약 - лекарство от головной боли - headache medicine
알약 - таблетка, пилюля - pill, tablet
가루 - порошок - powder
가루약 - лекарство в порошках - powder medicine
물약 - микстура - liquid medicine
콧물 - сопли - snot
콧물이 나다 - течь из носа - runny nose
설사 - понос, диарея - diarrhea
설사하다 - страдать диареей - Have loose bowels
주사 - укол, инъекция - injection
주사를 맞다 - получать инъекцию - Right injection
이미 - уже - already
다르다 - другой, разный - different
혼자 - один, в одиночку - Alone
무섭다 - страшный, страшно - Scary
배우 - актер - Actor
독일어 - немецкий язык - German language
곳 - место - place
한번 - как-нибудь - once
묻다 - спрашивать - ask
가수 - певец - singer
갑자기 - неожиданно - suddenly
잠이 오다 - клонит в сон - sleepy
싸우다 - ссориться - fight
박물관 - музей - museum
웃다 - смеяться - Laugh
크게 - большой, больше - big
