잠깐만요 - минуточку            - wait
알았어요 - понятно, ясно        - got it
좋습니다 - хорошо               - we recomend
싫어요 - Не хочу, не нравиться - I do't want
봄 - весна                     - spring
여름 - лето                    - summer
가을 - осень                   - autumn
겨울 - зима                    - winter
동쪽 - восточное направление   - east
서쪽 - западное направление    - west
남쪽 - южное направление       - south
북쪽 - северное направление    - north
가게 - лавка, магазин, киоск   - shop
호텔 - отель, гостиница        - hotel
손 - рука                      - hand
씻다 - мыть                    - wash
욕실 - ванная                  - bathroom
백화점 - универмаг             - department store
기숙사 - общежитие             - dorm
강아지 - щенок                 - puppy
바지 - брюки                  - pants
오전 - первая половина дня    - AM
아침 - утро, завтрак - morning, breakfast
시험을_보다 - сдавать экзамены - pass tests
아침을_먹다 - завтракать       - eat breakfast
점심 - обед                   - lunch
점심을_먹다 - обедать          - eat lunch
저녁을_먹다 - ужинать          - eat supper
작년 - прошлый год            - last year
공연 - представление, выступление - performance
시합 - соревнование           - match
이번 - этот раз               - this time
주 - неделя                   - week
연주회 - концерт инстр музыки - concert
다음 - следующее              - next 
다음_주 - следующая неделя    - next week
점심_시간 - обеденный перерыв - lunch break
쇼핑 - шоппинг                - shopping
쇼핑하다 - делать покупки      - do shopping
휴가 - отпуск                 - vacation
가장 - самый, больше всего    - most