아파트   - апартменты        - apartment
가깝다   - близкий           - close
목욕실   - душевая, ванная   - bathroom
현관     - прихожая          - porch
구석     - угол              - corner
며칠 전에 - несколько дней назад - a few days before
밝다     - светлый           - bright
편안하다  - спокойный, удобный - comfortable
이사오다  - переезжать      - move to
즐겁다    - веселый        - fun
침대      - кровать        - bed
주방      - кухня          - kitchen
심하다    - резкий, сильный - severe
정직하다   - честный         - honest
외투      - пальто          - coat
방금      - только что      - just now
아프다     - болит          - pain
이사하다   - переезжать 1   - move house
벌써      - уже            - already
지난 주   - прошлая неделя - last week
집들이    - новоселье      - housewarming
집들이하다 - устроить новоселье - make housewarming
꼭        - обязательно        - exactly, securely
네        - да                 - yes
안부 전해주다 - передать привет  - regards ??
안방        - комната родителей - inner room
엘리베이터   - лифт              - elevator
나오다      - выходить,появляться,выступать - come out, show up
전기        - электричество     - electricity
수도        - водопровод        - waterworks
난방        - отопление         - heating
따뜻하다     - теплая            - warm
행복하다  - счастливый      - happy
기쁘다    - радостный       - delight
도와주다  - помогать        - help
지금부터  - с этого момента - From now on
진지하다  - серьезный        - Earnest
슬프다    - грустный        - melancholy, sadness
과자      - печенье         - Confectionery
다치다    - ушибиться, повредить - damage
노래를 하다 - петь песню         - sing song
스필버그 - Спилберг - Spielberg
새 - новый - new
국립 - государственный - national
대학 - университет, институт - university
엠게우 - МГУ - MGU
전에 - раньше, прежде - before
잡다 - взять, поймать - catch
이렇게 - так - thus
이렇다 - такой, таков - thus, this
꿈을 꾸다 - видеть сон - dream
사우나 - сауна - sauna
사우나 하다 - мыться в сауне - wash in sauna
졸다 - дремать - nap, snooze
외우다 - учить, запоминать - learn, memorise


