예매 - предварительная покупка - ticketing?
도착 - прибытие - arrive
매표소 - билетная касса - ticket box
엄청나다 - непомерный, огромный - tremendous
줄 - веревка, линия, очередь - line
줄을 서다 - стоять в очереди - stand in line
회 - сеанс, раз - time, frame
팔리다 - быть проданным, распродаваться - sell, go
가지다,갖다 - иметь, брать - have, take
남다 - оставаться - remain, stay
휴게실 - фойе - foyer, rest area
걸리다 - зацепиться, повиснуть - get caught, hang
걸다 - зацеплять, вешать - catch, hang
공포 - страх - fear
공포 영화 - фильм ужасов - Horror movie
꼭 - крепко, обязательно - exactly, securely
잡다 - держать, ловить, хватать - catch, grasp, take
무섭다 - страшный, страшно - scary
무서워하다 - бояться - afraid, fear
사실 - факт, действительно - Actually, reality
사실은 - на самом деле - the fact is
겁 - страх, трусость - cowardice
겁이 나다 - страшно - scared
눈을 감다 - закрывать глаза - blind
근처 - окрестность - near by
근처에 - поблизости, в окрестности - near
헤어지다 - расставаться - say goobye, separate
들르다 - заходить, заглядывать - step in
재작년 - позапрошлый год - two years ago
크리스마스 - рождество - christmas
앉다 - сидеть - sit
눕다 - лежать - lay down
열리다 - открываться - open
공장 - завод, фабрика - factory, plant
정문 - главные ворота - front door
닫히다 - закрываться - close, shut
골묵 - переулок, закоулок - alley
막히다 - забиваться, закупориваться - blocked, clog, choke
달력 - календарь - calendar
찾아오다 - заходить, посещать - come to, visit
아기 - ребенок - baby
개월 - месяц - month
지내다 - проводить время, жить - stay, lead a life
비자 - виза - visa


