식구 - член семьи - family
스케이트 - коньки - skate
모든 - все, всё, весь - all
야구 - бейсбол - baseball
행복 - счастье - happiness
빠지다 - вязнуть, увлекаться - fall in
테니스 - теннис - tennis
골프 - гольф - golf
덜 - менее, не настолько - less
힘이 덜 들다 - не так тяжело - Have less strength
환갑 - 60-летний юбилей - 60-years
항상 - всегда - always
체력 - физическая сила, здоровье - health
주다 - услужить, дать - give
드리다 - дать (вежл) - give (polite)
돕다 - помочь - help
부르다 - звать, петь - call
알리다 - давать знать, сообщать - inform
보이다 - показывать, представлять - show
티셔츠 - футболка, Тшорт - T-shirt
려고 - чтобы - to
설명하다 - обьяснять - explicate
줄이다 - уменьшать, сокращать - reduce
미리 - заранее - beforehand, already
전하다 - передавать - give, transmit
농구 - баскетбол - basketball
조금만 - немного - a little bit
더 - больше - more
얼마나 - как, насколько - how much
입학 시험 - вступительные экзамены - Entrance examination
합격하다 - выдержать (экзамен, испытание) - Pass an examination

한참 - долгое время - long time
친척 - родственник - Relative
인사 - приветствие - Greetings
인사하다 - здороваться, приветствовать - Greet
부치다 - отправлять, посылать - send
빼다 - убирать, вынимать, удалять - remove
살빼다 - сбрасывать вес - Lose weight
야채 - овощи, зелень - vegetable
산책 - прогулка - walk
산책하다 - гулять - take a walk, walk
공 - мяч - ball
게임 - игра - game
혼이 나다 - быть отруганным, пройти испытание - Get frightened out
혼 - дух - spirit, ghost
영혼 - душа - soul
잃어버리다 - терять - lose
길 잃어버리다 - заблудиться - Get lost
아르바이트 - подработка - Part time job
아르바이트하다 - подрабатывать - Part-time
기침하다 - кашлять - Cough
놀러하다 - идти развлекаться - play
약국 - аптека - pharmacy
길이 막히다 - пробки на дорогах - blocked road
비탈리 - Виталий - Vitali



