약국 - аптека - pharmacy
이탈리아 - Италия - Italy
이기다 - побеждать - win
지다 - проигрывать - lose
팀      - команда - team
골         - гол - goal
골 넣다     - забить гол - Score
정신 없이    - без памяти, самозабвенно - Without a mind
소리        - звук, голос - sound, voice
소리를 지르다 - кричать - Yell
경기장       - стадион - Stadium
응원을 하다  - болеть (за команду) - Cheer
하지만      - однако, но - But
몸이 안 좋다 - плохо себя чувствовать - I feel bad
특별히 - особенно, специально - especially
밥맛 - аппетит - Appetite
금방 - сразу, моментально - soon
계속하다 - продолжать - Continue
그럼요 - конечно - of course
더럽다 - грязный - dirty
강 - река - River
강물 - речная вода - river water
수리 - ремонт, починка - repair
수리하다 - ремонтировать, чинить - repair
대청소 - генеральная уборка - cleanup
켜다 - включать - turn on
켜지다 - включаться - Turn itself on
끄다 - выключать, тушить - turn off
꺼지다 - выключаться, гаснуть - go out
지우다 - стирать - erase
지워지다 - стираться - Be erased
펴다 - раскрывать - spread, unfold
펴지다 - раскрываться - unfurl
이루다 - осуществлять - accomplish
이루어지다 - осуществляться - get accomplished
자르다 - отрезать - cut
잘라지다 - отрезаться - Be cut off
끊다 - разрывать, прекращать - quit
끊어지다 - разрываться, прекращаться - Be broken
꿈 - мечта, сон - dream
시합 - матч - match
시합하다 - соревноваться - play, compete
확인 - подтверждение, проверка - confirmation, verification
확인하다 - проверять, удостоверяться - confirm
가난하다 - бедный - poor
가난 - бедность - poverty
죄 - преступление, грех, вина - sin, crime
불편하다 - неудобный - Uncomfortable
불편 - неудобство - Inconvenience
익숙하다 - привычный - be used to
