같이 - вместе        - together
다시 - снова         - again
댁 - вежл дом        - home
그렇게 - так          - so
이따가 - после, потом - see you later
문 - дверь            - door
닫다 - закрывать      - close
잔 - чашка рюмка стакан - glass
저쪽 - там, туда       - beyond
맛있게 - вкусно, с апетитом - enjoy
들다 - вежл кушать пить     - eat,drink??
조심하다 - быть осторожным - beware
떠들다 - шуметь, галдеть - make a noise
늦다 - опаздывать        - late 
창문 - окно              - window
담배를 피우다 - курить    - smoke
부모 - родители - parents
님 - вежлив сир - sir
선생 - учитель - teacher
교수 - профессор - professor
지하철 - метро - subway
역 - станция - station
층 - этаж - floor
올라가다 - подниматься - go up, rise
들어가다 - заходить - enter
젓가락 - палочки - chopsticks
버스 - автобус - bus
밀가루 - пшеничная мука - flour
무슨 - какой, что за - what
무슨 일로 - по какому делу - what are you doing?
주부 - домохозяйка - Housewife
늦게 - поздно - late
출장 - командировка - business trip
출장을 가다 - ехать в командировку - go on a business trip


