싫다 - не хотеть - don't want
싫어하다 - не нравиться, не любить - don't like
죄송합니다 - извините_1 - Sorry_1
미안합니다 - извините_2 -  Sorry_2
실례합니다 - извините, прошу прощения - Excuse me
아버지 - отец - father
어머니 - мать - mother
형 - старш брат муж - older brother man
오빠 - старш брат жен - older brother fem 
누나 - старш сестра муж - older sister man
언니 - старш сестра жен - older sister fem
동생 - младш брат сестра - younger sister
남동생 - младш брат - younger brother
여동생 - младш сестра - younger sister
할아버지 - дедушка - grandfather
할머니 - бабушка - grandmother
외할아버지 - дедушка по матер - grandfather from mother
외할머니 - бабушка по матер - grandmother moth
삼촌 - дядя - uncle
조카 - племянник - nephew
아들 - сын - son
딸 - дочь - dauther
대사관 - посольство - embassy
극장 - театр, кинотеатр - theater
음악회 - концерт - concert
일어나다 - вставать - rise
숙제 - домашнее задание - homework
서울 - Сеул - Seoul
소포 - посылка - Package
독일 - Германия - Germany
팩스 - факс - fax
프랑스 - Франция - France
이메일 - емайл - email
모자 - шапка - hat
장갑 - перчатки - gloves
지도 - карта - map
학자 - ученый - scholar
차이코프스키 - Чайковский - Tchaikovsky
찾다 - искать - look up, search
잊어버리다 - забывать - forget
반지 - кольцо - ring
하고 - и,с (кем.чем л) - and, with
놀다 - развл, отдыхать, играть - play
자다 - спать - sleep
데이트 - свидание - date
데이트하다 - ходить на свидание - go to date
비디오 - видео - video
농구 - баскетбол - basketball
농구하다 - играть в баскетбол - play basketball
편안히 - спокойно - comfortably?
풀고기 - пульгоги блюдо - bulgogi
부모님 - родители - parents
택시 - такси - taxi
타다 - садиться, ехать, кататься - take, sit
