늦잠을 자다 - проспать - Sleep up late
금방 - сразу, моментально - Immediately
비다 - пустеть - be empty
빈 자리 - свободное место - an empty seat
지나다 - проходить - pass by, go past
내리다 - опускаться, выходить - come down, get off
매일 - каждый день - daily, every day
바빠다 - занят - busy
힘 - силы - power
결혼 - свадьба - marriage
결혼하다 - пожениться - Get married
참다 - терпеть - endure, tolerate
근처 - окрестность - Neighborhood
똑발로 - прямо - Straight
저기서 - оттуда, там - there
왼쪽으로 - налево - to the left
여기서 - отсюда, здесь - here
서울역 - Сеульский вокзал - Seoul Station
어떻게 - как - how
건너다 - переходить, переправляться - go over
시청 - мэрия - towan hall
시청역 - станция Мерия - Town Hall station
갈아타다 - пересаживаться - change, transfer
운전기사 - водитель - driver
신라호텔 - отель Силла - Shilla hotel
세워주다 - останавливать - stop??
길 - дорога - road
너무 - слишком, очень - too
막히다 - засоряться, забиваться - clog, block
퇴근 - возвращение с работы - leave office
퇴근 시간 - время возвращения с работы - end of office hours
계속 - постоянно, непрерывно - continuation, continuance
신호등 - светофор - Traffic light

