에서 - из - from
고향 - родной город - home town
가족 - семья, член семьи - family, member of family
가족들 - члены семьи - family members
모두 - всего все - all
여동생 - младшая сестра - younger sister
왔습니다 - приехал - came
어제 - вчера - yesterday
얕다 - мелкий, неглубокий - shallow
일찍 - рано                 - early
많이 - много                - many
앉다 - садиться             - sit down
참 - действительно, очень   - really, very
건물 - здание               - building
아주 - очень                - very
높다 - высокий              - high
서다 - стоять               - stay up
가르치다 - обучать, преподавать - teach
만들다 - делать, мастерить    - make
열심히 - усердно, старательно - hard
동안 - в течении             - while
김 - Ким (фамилия)           - Kim
정말 - правда, действительно - truth
재미있다 - интересный, смешной - funny
별로 - не особенно, не очень - not much, not especially
재미없다 - неинтересный, не смешной - not funny
피자 - пицца                  - pizza
맛 - вкус                    - taste
맛있다 - вкусный              - tastefull
생일 - день рождения         - birthday
깨끗하다 - чистый             - is clean ?
산책 - прогулка              - walk
산책하다 - гулять            - walk, go to walk
깨끗이 - чисто                 - clean
아까 - недавно (раньше сегодня) - earlier today
조용하다 - спокойный, тихий      - quiet
배고프다 - голодный             - hungry
다니다 - ходить, посещать       - attend
부산 - Пусан                 - Pusan
영국 - Англия                - England
미찌꼬 - Митико              - Mitiko
안경 - очки                  - spectacles
테레비 - телевизор            - tv
것 - вещь                    - thing
나라 - страна                - country
도서관 - библиотека          - library
화장실 - туалет              - toilet
피곤하다 - усталый             - tired
좀 - немного                 - little bit
쉬다 - отдыхать               - rest
제주도 - остров Чеджу         - Cheju Island
컴퓨터 - компьютер            - computer
