자매 - сестра      - sister
광장 - квадрат     - square
화분 - цвет горшок - flowerpot
돼지 - свинья      - pig
그리고 - и         - and
아름다 - красивый   - beautiful
같은 - такой        - such, identical
어린 - дети         - children
식물 - растение     - plant
정말 - правда       - I, truth
멋져 - великолепный - gorgeous
달라 - другой       - different
동물 - животное     - animal
아주 - очень        - very
길다 - длинный      - long
긴 - длинный1       - long1
생각하다 - думать     - think
생각 - мысль, мнение - thought, opinion
꼬리 - хвост         - tail
다리 - нога          - leg
아무 - никто,ничего  - nothing
냄새나 - вонючий      - stinky,smelly
하지만 - но           - but
욕심이 - жадный       - greedy
더러운 - грязный      - dirty
달려 - вверху         - up
위의 - над            - over
진짜 - настоящий      - real
한참 - долго?,высоко? - really,far
털   - шерсть, волосы - fur, hair
무늬 - пятна           - pattern
큰   - большой, гигантский - big, great
같    - такой же       - the same
뱀처럼 - вроде змеи     - like a snake
뱀    - змея           - snake
몸    - тело           - body
전체   - полностью      - entirety
덮여   - покрытый       - covered
올려다 - смотреть вверх - looking up
훬씬   - намного        - by far
더     - больше         - more
잘     - хорошо         - well
어울리 - подходит       - suitable
응    - да             - yeah
별로   - очень_1       - very_1
않아   - не очень      - be not
동시   - одновременно  - the same time
저렇게 - как это - like that
목 - горло, шея - throat, neck
한번도 - когда либо - ever
번도 - никогда - never
적 - раз,время,враг - time,enemy
웃다 - смеяться - laugh
이전 - раньше - previous, before
떨어 - вниз - down
침이 - слюна - saliva
있는데 - здесь - there
계속 - продолжать - continue
대해 - про, о ком - about
축축 - мокрый - wet
어떤 - этот - what, this
쪽으로 - к, в направлении - towards
다가오다 - подошел - come closer
조용히 - тихо - quiet
덩치가 - большой - big
자국 - страна, знак - country, sign
앞지마 - фартук - apron
매 - каждый - every
반대편 - другая сторона - other side




