 답장 - ответное письмо, ответ - reply
 답장을 하다 - отвечать на письмо - reply to
 우체통 - почтовый ящик - mailbox
 집어넣다 - класть, засовывать - put in
 물론 - конечно, разумеется - sure, of course
 외국 - иностранное государство, заграница - foreign
 우체국 - почтовое отделение - post office
 시작이 되다 - начинаться - start
 포장 - упаковка - packing
 포장을 하다 - упаковывать - wrap
 주소 - адрес - address
 적다 - записывать, писать - keep, write
 장 - сч слово бумага, раздел - chapter
 창구 - окно (кассы) - window
 직원 - служащий, сотрудник - employee, staff
 무게 - вес - weight
 무게를 하다 - взвешивать - weigh
 우표 - почтовая марка - stamp
 붙이다 - приклеивать - attach
 주일 - неделя - week
 후에 - после, через - after, later
 배달 - доставка - delivery
 배달이 되다 - быть доставленным - be delivered
 배달를 하다 - доставлять - deliver
 주말 - выходные дни - weekend
 당구 - бильярд - billiards
 당구를 치다 - играть в бильярд - play billiards
 우울하다 - унылый - Depressed
 아니면 - или - if not
 바보 - дурак - Fool
 완전히 - совсем, полностью - Completely
 낫다 - лучший, проходить, заживать - better, heal, cure
 수술 - операция - Operation
 수술을 하다 - делать операцию, оперировать - Do surgery
 취직 - поступление на работу - Employment
 취직을 하다 - поступать на работу - Get a job
 햄버거 - гамбургер - hamburger
 도저히 - никак, никоим образом - By no means
 졸리다 - клонить ко сну, хотеть спать - Sleepy
 그램 - грамм - gram
 둘 다 - оба - both
 미연 - МиЁн - Mi-Youn
 우편 - почта, корреспонденция - post, mail
 빠른 우편 - срочная почта - Fast mail
 하루 - сутки - a day
 등기 - регистрация - registered
 등기 우편 - заказная почта - Registered mail
 일반 - обычный - Normal
 아무거나 - любой - anything
 봉투 - конверт - envelope
 전부 - всего, все, полностью, целиком - all, in full
 
 
 
 
 
 
 