잠이 들다 - заснуть - put to sleep
바닥 - пол - floor
줍다 - подбирать, поднимать - pick up
그치다 - прекращаться - stop
코피 - кровь из носа - Nosebleed
피 - кровь - blood
피가 나다 - появляться, течь (о крови) - I have blood.
멈추다 - останавливать(ся), прекращать(ся) - stop, halt
국 - суп - soup
출발 - отправление, отьезд - Start, take-off
출발하다 - отправляться, выезжать - depart
들어가다 - входить, заходить - go in
생신 - день рождения - birthday
축하 - поздравление - congratulation
축하를 하다 - поздравлять - Celebrate
축하를 드리다 - вежл поздравлять - Congratulate
저희 - мы, наш, мой - we
방송국 - радиостанция, телестанция - Broadcast stations
세상 - мир, свет - world
동물 - животное - animal
체조 - зарядка - Gymnastics
브라질 - бразилия - Brazil
네덜란드 - Нидерланды - Netherlands
스파르타크 - Спартак - Spartac
비기다 - сыграть вничью - draw
돈을 벌다 - зарабатывать деньги - Earn money
어둡다 - темный - dark
성적 - успеваемость, оценки - achievement
짧다 - короткий - short
초대장 - писменное приглашение - invitation
사이 - промежуток, интервал, отношения - interval, between, connections
지겹다 - надоевший - boring
조금 전까지 - вплоть до недавнего момента - Until a little before
십다 - хочется - like, want
싫다 - не хочется - hate
흐리다 - пасмурный, тусклый - cloudy
맑다 - ясный, чистый, прозрачный - clear
발음 - произношение - Pronunciation
깨다 - разбивать - break
생기다 - появляться, возникать - form, arise, come into being
내려가다/오다 - спускаться, опускаться - go down
넘어지다 - падать - fall down
생각이 나다 - вспоминаться, приходить в голову - bring to mind
그렇지요? - не так ли? - That's right.
우선 - в первую очередь, прежде всего - first
자세히 - подробно, детально - Details
말씀을 드리다 - вежл говорить - Give a word
에 대해 - о ком,чем; про кого чего - about
정리 - приведение в порядок, упорядочивание - arrangement
정리하다 - приводить в порядок - Straighten out
인분 - порция - serving
느끼다 - чувствовать, ощущать - feel
