여러 - много, несколько, разный - many, various
편 - часть, раздел - side
요새 - нынче, в последнее время - these days
볼 만하다 - стоит посмотреть - Worth seeing
해리 포터 - Гарри Поттер - Harry Potter
오래 - длинный - long
오래 전에 - давно - A long time ago
어느 - какой - which
베니스 - Венеция - Venice
영화제 - кинофестиваль - Film Festival
감독 - режиссер, тренер, инспектор - director
상 - приз, награда - Prize
타다 - получать, ехать - ride, receive
상을 타다 - получить приз - Pull off
관객 - зритель - audience
넘다 - преодолевать, превышать - exceed
유명하다 - известный, знаменитый - Famous
대단하다 - выдающийся, необычайный - Awesome
대단 - большой, громадный - large, great, enormous
이렇다 - такой (вблизи) - this (near)
그렇다 - такой (вдали) - this (far)
저렇다 - такой (твой) - this (your)
빨갛다 - красный - is red
파랗다 - синий - Is blue
까맣다 - черный - is black
하얗다 - белый - is white
노랗다 - желтый - is yellow
어떻다 - какой - how
색깔 - цвет - color
블라우스 - блузка - blouse
놓다 - класть на - put on
넣다 - класть в - insert
추천 - рекомендация - recomendation
추천하다 - рекомендовать - recommend
벌 - наказание - punishment
짓 - поступок, выходка - act
주인공 - главный герой - main hero
괜히 - зря - in vain
감독 - режиссёр - director
어잿밤 - вчерашняя ночь - yesternight
사랑 - любовь - love
걱정 - беспокойство, волнение - anxiety, worry
걱정 없다 - беззаботный - Do not worry
걱정 하다 - беспокоится, волноваться - be afraid, worry
나타샤 - Наташа - Natasha
치마 - юбка - skirt
오르다 - подниматься, повышаться - rise, climb
문을 닫다 - закрывать дверь, закрываться - Shut the door
한가하다 - свободный, незанятый - it is idle
한번 - как-нибудь - once
추석 - Чусок, благодарение - Thanksgiving
파티 - вечеринка - party
졸업 - окончание УЗ - Graduated
졸업식 - вручение дипломов - graduation
여행 가다,여행을 하다 - поехать в путешествие - Go travel, it is a journey
컵 - чашка, стакан, кубок - cup
시간표 - расписание - schedule
붙다 - приклеиваться - stick
쓰레기통 - мусорное ведро - trash can
스페인 - Испания - Spain
선수 - спортсмен, игрок - player
축구선수 - футболист - Football player
환자 - пациент, больной - patient
그동안 - в течение этого времени - Meantime
준비 - подготовка - Preparations
질문 - вопрос - Question
질문 하다 - задавать вопрос - Ask a question
그 후에 - после этого - After that
돌려 주다 - возвращать - Give back
대답 - ответ - answer
대답 하다 - отвечать - answer, respond
귤 - мандарин - tangerine
방법 - метод, способ - method, way
장미 - роза - rose
나뭇잎 - лист дерева - tree leaf
잎 - лист - leaf
하늘 - небо - sky
유행 - мода, распространение - trend, mode, fashion
유행이다,유행하다 - модный - fashionable
운동화 - кроссовки, кеды - running shoes, sneakers
끼다 - вставлять, нанизывать - put on
장갑을 끼다 - надевать перчатки - Put on the gloves
왠지 - почему-то - somehow
언제나 - всегда - always
부모님이 안 계시다 - родителей нет - no parents
문제 - вопрос, задача, проблема - problem, question
답 - ответ - answer
간단하다 - простой, краткий - simple
수미 - Суми (имя) - Sumi (name)
사촌 - кузен, кузина - cousin
말을 안 듣다 - не слушается - Do not listen to the words
고장 - поломка - broken
고장이 나다 - ломаться - fail
얘기 - разговор, рассказ - story
거기 - там - there
돈을 벌다 - зарабатывать деньги - Earn money
어둡다 - темный - dark
