닮다 - быть похожим, походить - resemble
승리 - победа - victory
승리 공원 - Парк Победы - Victory Park
귀엽다 - милый, симпатичный - cute
되게 - сильно, очень - very
지각 - опоздание, впечатление - being late, perception
지각하다 - опаздывать - perceive, come late
기회 - шанс, возможность - chance, opportunity
놓치다 - выпустить, упустить - miss, waste
대사 - посол - ambassador
하루 - сутки, один день - one day, day
이틀 - два дня - two days
사흘 - три дня - three days
나흘 - четыре дня - four days
열흘 - десять дней - Ten days
보름 - пятнадцать дней - fifteen days
처음으로 - в первый раз - For the first time
사일 안에 - в пределах трёх дней - in three days
비우다 - опорожнять, опустошать - vacate, empty
수돗물 - водопроводная вода - tap water
우체부 - почтальон - mailman
그날 - тот день - that day
또는 - или - or
주로 - главным образом, в основном - mainly
집안 일 - работа по дому - housework
그립다 - полный тоски по кому/чему-л - miss you
수학 - математика - Math, mathematics
전화를 받다 - отвечать на звонки, брать трубку - Receive a call
몹시 - очень, ужасно - really, terribly
연습 - упражнение, тренировкаб репетиция - practice, exercise
연습을 하다 - упражняться, тренироваться - Practice
자꾸 - всё время, то и дело - Repeatedly
지하도 - подземный переход - underpass
자르다 - отрезать, разрезать - cut
머리를 자르다 - стричь волосы - cut hair
미용실 - салон красоты, парикмахерская - beauty salon
전자 - электроника, электрон - Electronic, electron
제품 - изделие, товар - product, manufacture
대학원 - магистратура, аспирантура - Graduate school
서류 - документ - document
복사하다 - делать копию, размножать - To copy
모으다 - собирать, копить - collect, gather, accumulate
회의 - собрание - conference
회의하다 - проводить собрание - Discuss
오이 - огурец - cucumber
당근 - морковь - carrot




 
 
 
 
 
 
 
 
 